####################
#A#                B#
# ###### #########  #
#       #     #     #
##### # # # ### ### #
#   # #   #   #     #
# # ##### # # # ### #
# #         #   #   #
# ######### ####### #
#                   #
# ### ########### # #
#   #         #   # #
# # ##### ### ### # #
# #     #   # #   # #
# ### ### # # ##### #
#     #   #     #   #
##### ######### ### #
#                   #
####################